NO ./img/exit.xpm
SO ./img/player.xpm
WE ./img/player.xpm
EA ./img/start.xpm

C 173,216,230
F 220,174,150

        111111 111111111111111111
        100001 100110000000000001
        1011011101110000000000001
        1001000000000000000000001
111111111011000001110000000000001
100000000011000001110111111111111
11110111111111011100000000001
11110111111111011101010010001
11000000110101011100000010001
10000000000000001100000010001
10000000000000001101010010001
11000011111101011111011110W011
1111011   110101 101111010001
1111111   111111 111111111111
