NO ./img/coll.xpm
SO ./img/empty.xpm
WE ./img/player.xpm
EA ./img/start.xpm
F 220,100,10


C 225,30,0

111111111
100000001
1000N0001
100000001
111111111